XXXXXXXXXXXXXXXXXXXXXX       XXXXXXXXXXXXXXXXXXXXX
XXXXXXXXXXXXXXXXXXXXXX       XXXXXXXXXXXXXXXXXXXXX
XXXXXXXXXX                   XXXXXXXXXXXXXXXXXXXXX
XXXXXXXXXX                   XXXXXXXXXXXXXXXXXXXXX
XXXXXXXXXX     XXXXXX        XXXXXXXXXXXXXXXXXXXXX
XXXXXXXXXX     XXXXXX        XXXXXXXXXXXXXXXXXXXXX
XXXXXXXXXX                      XXXXXXXXXXXXXXXXXX
XXXXXXXXXX                      XXXXXXXXXXXXXXXXXX
XXXXXXXXXXXXXXXXXXXXXXXXXX      XXXXXXXXXXXXXXXXXX
XXXXXXXXXXXXXXXXXXXXXXXXXX                  XXXXXX
XXXXXXXXXXXXXXXXXXXXXXXXXX                  XXXXXX
XXXXXXXXXXXXXXXXXXXXXXXXXX      XXXXXXXXXXXXXXXXXX
XXXXXXXXX                       XXXXXXXXXXXXXXXXXX
XXXXXXXXX                       XXXXXXXXXXXXXXXXXX
XXXXXXXXX      XXXXXXXXXXXXXXXXXXXXXXXXXXXXXXXXXXX
XXXXXXXXX      XXXXXXXXXXXXXXXXXXXXXXXXXXXXXXXXXXX
XXXXXXXXX                       XXXXXXXXXXXXXXXXXX
XXXXXXXXX                       XXXXXXXXXXXXXXXXXX
XXXXXXXXXXXXXXXXXXXXXXXXXX      XXXXXXXXXXXXXXXXXX
XXXXXXXXXXXXXXXXXXXXXXXXXX      XXXXXXXXXXXXXXXXXX
XXXXXXXXXXXXXXXXXXXXXXXXXX                  XXXXXX
XXXXXXXXXXXXXXXXXXXXXXXXXX      XXXXXX      XXXXXX
XXXXXX                                      XXXXXX
XXXXXX                                      XXXXXX
XXXXXX                                      XXXXXX
XXXXXXXXXXXXXXXXXXXX      XXXXXXXXXXXX      XXXXXX
XXXXXXXXXXXXXXXXXXXX      XXXXXXXXXXXX      XXXXXX
XXXXXXXXXXXXXXXXXXXX            XXXXXX      XXXXXX
XXXXXXXXXXXXXXXXXXXX                        
XXXXXXXXXXXXXXXXXXXXXX                      
XXXXXXXXXXXXXXXXXXXXXX          XXXXXXXXXXXXXXXXXX
XXXXXXXXXXXXXXXXXXXXXX       XXXXXXXXXXXXXXXXXXXXX
XXXXXXXXXXXXXXXXXXXXXX       XXXXXXXXXXXXXXXXXXXXX
XXXXXXX                      XXXXXXXXXXXXXXXXXXXXX
XXXXXXX                      XXXXXXXXXXXXXXXXXXXXX
XXXXXXX                      XXXXXXXXXXXXXXXXXXXXX
XXXXXXX     XXXXXXXXXXX      XXXXXXXXXXXXXXXXXXXXX
XXXXXXX     XXXXXXXXXXX      XXXXXXXXXXXXXXXXXXXXX
XXXXXXX     XXXXXXXXXXX                   XXXXXXXX
XXXXXXX     XXXXXXXXXXX       XXXXXXXXX   XXXXXXXX
XXXXXXX                       XXXXXXXXX   XXXXXXXX
XXXXXXX                         XXXXXXX   XXXXXXXX
XXXXXXX                         XXXXXXX   XXXXXXXX
XXXXXXXXXXXXXXXXXXXXXXX         XXXXXXX   XXXXXXXX
XXXXXXXXXXXXXXXXXXXXXXX         XXXXXXX   XXXXXXXX
XXXX                                      XXXXXXXX
XXXXXXXXXX      XXXXXXX                   XXXXXXXX
XXXXXXXXXX      XX             XX     XXXXXXXXXXXX
XXXXXXXXXX      XX             XX     XXXXXXXXXXXX
XXXXXXXXXX      XX             XX     XXXXXXXXXXXX
XXXXXXXXXX      XX             XX     XXXXXXXXXXXX
XXXXXXXXXX      XX             XX     XXXXXXXXXXXX
XXXXXXXXXX      XX                    XXXXXXXXXXXX
XXXXXXXXXX                            XXXXXXXXXXXX
XXXXXXXXXX                            XXXXXXXXXXXX
XXXXXXXXXXXXXXXXXXXXXXXXXXXXXXXXX     XXXXXXXXXXXX
XXXXXXXXXXXXXXXXXXXXXXXXXXXXXXXXX     XXXXXXXXXXXX
XXXXXXXXXXXXXXXXXXXXXXXXXXXXXXXXX     XXXXXXXXXXXX
         XXXXXXXXXXXXXXXXXXXXXXXX     XXXXXXXXXXXX
         XXXXXXXXXXXXXXXXXXXXXXXX     XXXXXXXXXXXX
         XXXXXXXXXXXXXXXXXXXXXXXX     XXXXXXXXXXXX
XXXXXXXXXXXXXXXXXXXXXXXXXXXXXXXXX     XXXXXXXXXXXX
XXXXXXXXXXXXXXXXXXXXXXXXXXXXXXXXX     XXXXXXXXXXXX
XXXXXXXXX                             XXXXXXXXXXXX
XXXXXXXXX                             XXXXXXXXXXXX
XXXXXXXXX      XXXXXXXXXXXXXXXXXX     XXXXXXXXXXXX
XXXXXXXXX      XXXXXXXXXXXXXXXXXX     XXXXXXXXXXXX
XXXXXXXXX      XXXXXXXXXXXXXXXXXX     XXXXXXXXXXXX
XXXXXXXXX      XXXXXXXXXXXXXXXXXX     XXXXXXXXXXXX
XXXXXXXXX      XXXXXXXXXXXXXXXXXX     XXXXXXXXXXXX
XXXXXXXXX      XXXXXXXX               XXXXXXXXXXXX
XXXXXXXXX      XXXXXXXX               XXXXXXXXXXXX
XXXXXXXXX      XXXXXXXX               XXXXXXXXXXXX
XXXXXXXXX      XXXXXXXXXXXXXXXXXXXXXXXXXXXXXXXXXXX
XXXXXXXXX      XXXXXXXXXXXXXXXXXXXXXXXXXXXXXXXXXXX
XXXXXXXXX      XXXXXXXXXXXXXXXXXXXXXXXXXXXXXXXXXXX
XXXXXXXXX                                   XXXXXX
XXXXXXXXX                                   XXXXXX
XXXXXXXXXXXXXXXXXXXX      XXXXXXXXXXXXX     XXXXXX
XXXXXXXXXXXXXXXXXXXX      XXXXXXXXXXXXX     XXXXXX
XXX                                         XXXXXX
XXX                                   XXXXXXXXXXXX
XXXXXXXXXXXXXXXXXXXXXXXXXXXXXXXX      XXXXXXXXXXXX
XXXXXXXXXXXXXX                        XXXXXXXXXXXX
XXXXXXXXXXXXXX                        XXXXXXXXXXXX
XXXXXXXXXXXXXX      XXXXXXXXXXXX      XXXXXXXXXXXX
XXXXXXXXXXXXXX      XXXXXXXXXXXX      XXXXXXXXXXXX
XXXXXXXXXXXXXX      XXXXXXXXXXXX         XXXXXXXXX
XXXXXXXXXXXXXX                           XXXXXXXXX
XXXXXXXXXXXXXX                           XXXXXXXXX
                    XXXXXXXXXXXXXXXXXX   XXXXXXXXX
                    XXXXXXXXXXXXXXXXXX   XXXXXXXXX
XXXXXXXXXXXXXXXXXXXXXXXXXXXXXXXXXXXXXX   XXXXXXXXX
XXXXXXXXXXXXXXXX                         XXXXXXXXX
XXXXXXXXXXXXXXXX                         XXXXXXXXX
XXXXXXXXXXXXXXXX      XXXXXXXXXXXXXXXXXXXXXXXXXXXX
XXXXXXXXXX            XXXXXXXXXXXXXXXXXXXXXXXXXXXX
XXXXXXXXXX                                  XXXXXX
XXXXXXXXXX                                  XXXXXX
XXXXXXXXXXXXXXXXXXXXXXXXXXXXXXXXXXXXXX      XXXXXX